
F 155,202,243
C 208,171,147
NO ./assets/cat/albanie.xpm

SO ./assets/g.xpm
WE ./assets/b.xpm
EA ./assets/y.xpm

1111111111111
100000000001
100000000111
1011001001111
10010000N0X01
1111111111111