
F 155,202,243
C 208,171,147

NO ./assets/cat/albanie.xpm
SO ./assets/g.xpm
WE ./assets/b.xpm
EA ./assets/y.xpm


        1111111111111111111111111
        100D000000110000000000001
        1011000001110000000000001
        1001000000000000000000001
111111111011000001110000000000001
1000000X0011000001110111110111111
11110111111111011100000010001
1111D111111111D111010100D0001
110X0000110101011100000010001
100000000000000011000000D0X01
1000X00000000000D001010010001
1100000D1D0D0D011111011110N0111
11110D11 1DD0D01 111111110001
11111111 1111111 111111111111