NO assets/rock.xpm







SO assets/window.xpm



F 208,171,147
C 155,202,243





WE assets/brick.xpm
EA assets/wood.xpm







        1111111111111111111111111
        1000000000110000000000001
        1011000001110000000000001
        1001000000D00000000000001
111111111011000001110000000000001
10000000001100000111D11111D111111
11110111111111011100000010001
11110111111111D111010100D0001
11000000110101011100000010001
10000000000000001100000000001
1000000000000000DD01010010001
1100000D1D0D0D011111011110N0111
11110D11 1DD0D01 101111010001
11111111 1111111 111111111111
